1111111111111111111111111111111111111111111111111111111111111111111111111111111111111111111111111111
1101100100001001010100110011001010100101010001111101110011101001000111110111110101001000100100000001
1110000101100011110110110100000000100010010011101001111000100111100001000000010011111001001011100101
1100000011100010001111010000101000000101000110110011110100110010101011010110101101110000110111111101
1010110101000101100100011100101111100111011110001111000110011110110000011100100011010011100101010001
1010101110001100011000100001101001101110010010101001011110010011010001100110110010111010111001110001
1000100111111110100101001001110101101111110100011101000000010001010000110110001100111011001011001101
1101000011001000101011000001100101010010001111110110010001110111111110110000001111010010011100011111
1110100001011001111010010011001111111110110101101000011011111010100101111001010000101110111101011111
1010010101110100100101000100110100111111110100010001011111101001110101100100000100010011000101100111
1011011001011001010000111000101101010111001110001100010000011101010111001100011001000001110101111001
1101100000101110100111011101100000110011000000100101100001100111111010100001001010111111111001000011
1101011010010110100110011101101010110000001111100100011011000111010100110101010110110000010110010011
1001011101001100000100011000010001000000111010010010111111111100010010111000111001100101000101010111
1100001010001001101110000010011111111101111010111011110110001010100111011110100000001011011100111111
1000100010010100010111110110010111111110100110100111100110110111101110011000110110111110110010100101
1111011000000110000001000010001000100110000001110100001100000001101000001011011011111011111101111111
1100011100000111101000100001001100110011100111111011011000101101110101011100001011110011101100010011
1011111000001111101011001101101001100110110100010110000000001110011110010011000011000010100110000101
1111011010001101001110111001010111101010100101110111100101101110011100001111001101110000011101001011
1111100111001101111001101111011000100010000101111010001111111000011100100000000011111000100100010011
1110111001000001100001010000010011110101000000000000001001000011111010100111011001110010011101100101
1100101110110010011111101111100000000010100001010111100000010011111011000111011110111001001110000001
1011110101010111000001001001111001001011001111111011011100100000011010101001011001100010011111001111
1100000101100110111101100111000000110101011000000100000010100100011110011011101001000010111010101011
1101001001011000001010010111110000000000001111100001001001010101110010111111110001101001110100110111
1011111100110011010111010000011110010001001000101011001110100001101001101010111011111101101100000101
1101011101100101001101101100110111101000000101000000101000110000111111111010000001101101101100110011
1010111010101100010000111111101110111100101001000001110111111110001110001111110011101000010000001001
1100011111100111010001011111111011001110001110001110011000010001001000010000101101101111101011011001
1011010011111001110100010001000111100011000001111010000010111110110101001101101110100010010000100001
1101110011100101001111001000110010111111110101100101000111010010000001001111111000000110000010000001
1101110011001101011110001011110100111010100010001101000000000001000110101111101111110100000010101101
1010101100000000000110001000001111100000010100001011000011000111000101011101111011010010100101110111
1010111011011010100100100111100111110101000001011000110011100000010011000001011100111110111000101011
1110111100111100101010101000100011111111001100011011101011101001010000001011100111000011001111100101
1011101110010110111101101000110111000100100010101001000000111110001010000010011110001001110100011011
1100110010101111011001001010001000111010100110100010111111101100001111110101011100010100101010110011
1101001000011001001000111000110100010100001001100110110010000011100010011110111010100001001001000111
1001100010110001010010101000011011011010010100001001100011100100100111101001001011000100001100111111
1111011110011010100011100100110001001000011000000101010111001011110011011110101100011010110001000011
1010001101001100100101000111110101011000101011100110100010110111001001011000001011010001010011111111
1000001000110110010000011011111011110011010101100011100100111111101001011110100110011110100110101011
1111010010010101011010010010101101101011011110000001000010110010111000010011010011110001111001100111
1001100100011011010000110110100111001011011100111000011011100100011001000111010101001110000101110101
1110110000100000001011111010100101100000000101001111101111110101101100001110101111001011001011010101
1001110111100000001011000111000001000011001010001000110111000111110110101101100010010011001010111011
1100101010111101110110001110100100100010001111110100100100111011100110010111111001111010110000010001
1111000000000110100011010101011101101000001000000101001101100111111001100010011101010001110100001101
1100001011111110010111110111101100111011100010011101111010110111011001100001010000101110110111111001
1010001111100100001001011000010000000111001001100011100110111101010101100000111100101000000111110101
1010001111101110011100001101111010100010101001001000011011011111111001110100001000000010101100111111
1000011010000110001110010110111111111111011111110100101011010001111010010110010010101000010001011111
1100101111010000101010001001100111100110001100111001001011011110100101100011001011011100000011110101
1101100001000101101111001110110010101010101010101001011101110000111110000011111110111011001111011011
1011011101001000100010111001100010000111001000010111111000001100001110100110101010111110010110000011
1001010110000110110010100100111110111101010111110111101001111100110100101010000010101001000011101011
1100101101111101010111000101010100101111010001001000110111101110011100011011000101110100001000101011
1110100111100110110110010111001111011101000100010010111111010100010110000100110000010000000001000011
1111101101111111010000001001001011000101000011100011011100000000011000111010111000110100110000101111
1100011010110100110110011000001000100010010001101010011000010111001100110100111001010001011101100001
1000001010011110011110000111101000100111000010010001100000011010000010110100010011001000011010100101
1011001101110101110011100010010011000001010101001000000011101111010000011111000000000011011011101101
1111100010101011100101101001000101110000101011110100000000100000011011101010110011011110100111000001
1010110110010001110011100010010010110010111010111101010100100001011011010000101111011001011011111111
1000101111011100110110110100100010011001001111011110110100011100100111101011000000100110110101011011
1100110001101010011011101010111101011000010111001101010001110010011001000100100000110001100101100001
1000100000010101001001010111111011010000100111110000101100001101001011101100001010110000111101111101
1000110011110110111001011111101101101111101000110010111110001001101000011101010010110101011111001011
1011111110110100100010111101011101000010000111011101111010101001001010010010010111111100111000110111
1000110100011100100110010011000110011110001110001011111010100011100001100010110010110010000101101111
1011100110010001010001100011111111001100101010110011011010101110110010010000001100100111111000000111
1011101101110100101011111010111010010001110111011000110100101101100100100110100000101100000001101111
101111100001101101011111011110E0110000100011001001101010000C1111111000000110011100110000011101010011
1010001110111001110110011010110101011101111101111010101100011000011100111000110100011010100111010111
1010000011110101100101001110010111110000101100000100010110001010000001110001110101110110001111100111
1101110111100101100110000010010001011000010101111000111101110111001110010011010110100111000001001001
1000110010111101011000010100001001101001101100111100111010101111100100010101000111111101111000101111
1010011101110100000010101100010010010011011110101101111011110001000110011111100011100011101101010101
10111010011101101110111101001000111011111P0001010100000100001100101010100110000110000100100111010111
1110100001000011000111000101110010100101111011110010000110111110001110111111001001100000010110111011
1100000011001101101011101101001110111111110111010111001100011101101000111000000011011010111001100111
1111101110010011101110101011011110011001001010110010010010011010010111000011001111011101010111100111
1111110001000001111000111110010010101101111100000100010001010111101101101010001101110000101000010001
1010111011010111100010001001000000110001010010000100101101000011001010111101000010110110000100001101
1100111000100100110110010111011011100001011100111111011011111101010101000100100001100001000000101111
1000101010100010100011011011111111001111110111010010110111010011100011100001100111111010000011001011
1100101110011000010110011000110000010111100111110100110100100011011000000111110010111111111101010101
1000001000110110101001001101111010110000001011110010110111001001001011111001000001110001100101110111
1011000100111000001010000100101000100001101101110110100011100000111000100100100001110000010110100101
1001000001110011101110111000001100011010000101110101010101010001100110010100001001111110011100111111
1011100101000001101101001101011101110011111011001000001010011100001100101001111101000101001110011101
1101110000000101010110010100000000110001101110001100100110010111111010011010101110111110110010011101
1011101000011101011110101001011100000101011010100100011110111000010110000100101010011010111101001101
1011000101110001001101000001111101111110000111001010010011010100100001101001100101000101110110110111
1000111000000100000111010110101100010101010011011010101011010110100111100101101010100011010001000001
1100101100111110001100101110101101000010101000100010100010100100010001001100101000001001011101001111
1111010011110100110011001011001000010001011000110011000101001101101010001101011001010001101010100101
1010100001000011010001000100110100011101000010000100000111100011001001101010010110101010111100000111
1111111111111111111111111111111111111111111111111111111111111111111111111111111111111111111111111111
