1111111111111111111111111111111111
1E0000000000000C00000C00000000001
10100101001000001010010000000101
10100100101010100010010000000101
1P0000000C00C00000000000000000001
1111111111111111111111111111111111
